---------------------------
---------------------------
-----------------#---------
-------------#------#------
---------#-------------#---
-@--------------------#####
-#---#--------------#######
-------------#-----########
----------#--#--#--########
########^^#^^#^^#^^########
6, 1