---------------
---------------
--------#------
--#------------
------#--#-----
0, 0