-------------
-------------
-----------@-
-----#--#--#-
###^^#^^#^^#^
2, 1