-------------
-------------
------------@
#-----#--#--#
####^^#^^#^^#
2, 1