---------------------------
---------------------------
-----------------#---------
-------------#------#------
---------#-------------#---
-@------------------------#
-#---#-------------------##
-----------------#-----####
######--------#--#--#--####
############^^#^^#^^#^^####
6, 1